border-image 	A shorthand property for setting all the border-image-* properties 	3
border-image-outset 	Specifies the amount by which the border image area extends beyond the border box 	3
border-image-repeat 	Specifies whether the border image should be repeated, rounded or stretched 	3
border-image-slice 	Specifies how to slice the border image 	3
border-image-source 	Specifies the path to the image to be used as a border 	3
border-image-width 	Specifies the widths of the image-border 	3

box-decoration-break 	Sets the behaviour of the background and border of an element at page-break, or, for in-line elements, at line-break. 	3
text-underline-position 	Specifies the position of the underline which is set using the text-decoration property 	3

inline	 	Default value. Displays an element as an inline element (like <span>) 	Play it »
block 		Displays an element as a block element (like <p>) 	Play it »
flex 		Displays an element as an block-level flex container. New in CSS3 	
inline-block 	Displays an element as an inline-level block container. The inside of this block is formatted as block-level box, and the element itself is formatted as an inline-level box 	
inline-flex 	Displays an element as an inline-level flex container. New in CSS3 	
inline-table 	The element is displayed as an inline-level table 	 
list-item 		Let the element behave like a <li> element 	Play it »
run-in 		Displays an element as either block or inline, depending on context 	 
table 		Let the element behave like a <table> element 	
table-caption 	Let the element behave like a <caption> element 	
table-column-group 	Let the element behave like a <colgroup> element 	
table-header-group 	Let the element behave like a <thead> element 	
table-footer-group 	Let the element behave like a <tfoot> element 	
table-row-group 	Let the element behave like a <tbody> element 	
table-cell 	Let the element behave like a <td> element 	
table-column 	Let the element behave like a <col> element 	
table-row 	Let the element behave like a <tr> element 	
none 		The element will not be displayed at all (has no effect on layout) 	Play it »
initial 		Sets this property to its default value. Read about initial 	Play it »
inherit 		Inherits this property from its parent element. Read about inherit 	

